........#
........#
..####.##
........#
#.......#
.......##
.#####..#
........#
#########