.....####
.########
........#
..#####.#
..#...#.#
..#...#.#
#.#.###.#
#.#.....#
#########
