.......##
.#.###.##
.#.###.##
.#.###.##
.#.###.##
.#...#.##
.#.....##
....#####
#########