#......##
#.####.##
.......##
..####.##
.##....##
.##.##.##
..#....##
#.###..##
#.###..##
